R 1920 1080

NO ./textures/eagle.xpm
SO ./textures/bluestone.xpm
EA ./textures/wall_1.xpm
WE ./textures/purplestone.xpm

S ./textures/eagle.xpm

F 51,10,51
C 51,204,255

                                                        1 1 1 1 1 1 1 1 1 1 1 1
          1 1 1 1 1 1                                   1 0 0 0 0 0 0 0 0 0 0 1
          1 0 0 0 0 1             1 1 1 1 1 1 1 1 1 1 1 1 0 0 0 0 0 0 0 0 0 0 1 1 1 1 1
          1 0 0 0 0 1             1 0 0 0 0 0 0 0 0 0 0 1 0 0 0 0 0 0 0 0 0 0 1 0 0 0 1
          1 0 0 0 0 0 1           1 0 0 0 0 0 0 0 0 0 0 0 0 0 0 0 0 0 0 0 0 0 0 0 0 0 1
          1 0 0 0 0 0 1           1 0 0 0 0 0 0 0 0 0 0 1 0 0 0 0 0 0 0 0 0 0 1 0 0 0 1
          1 1 1 1 1 0 1 1 1 1 1   1 0 0 0 1 1 1 1 1 1 1 1 0 0 0 0 0 0 0 0 0 0 1 1 1 1 1
          1 0 0 0 0 0 0 0 0 0 1   1 0 0 0 1             1 0 0 0 0 0 0 0 0 0 0 1
          1 0 0 0 0 0 0 0 0 0 1 1 1 0 0 0 1 1 1         1 1 1 1 1 0 1 1 1 1 1 1
          1 0 0 0 0 0 0 0 0 0 1 0 0 0 0 0 0 0 1               1 0 0 0 1
          1 0 0 0 0 0 0 0 0 0 0 0 0 0 0 0 0 0 1               1 0 0 0 1
          1 0 0 0 0 0 0 0 0 0 1 0 0 0 0 0 0 0 1               1 0 0 0 1
1 1 1 1 1 1 0 0 0 0 0 0 0 0 0 1 1 1 1 1 1 1 1 1               1 0 0 0 1
1 0 0 0 1 1 0 0 0 0 0 0 0 0 0 1                               1 0 0 0 1
1 0 0 0 1 1 1 1 1 1 0 1 1 1 1 1                     1 1 1 1 1 1 0 0 0 1 1 1
1 0 0 0 1 0 0 0 1 0 0 0 1                           1 0 0 0 0 0 0 0 0 0 0 1
1 1 0 1 1 0 0 0 1 0 0 0 1                           1 0 0 1 1 1 0 0 0 1 1 1
1 0 0 0 1 1 1 1 1 0 0 0 1                           1 0 0 1 1 1 0 0 0 1
1 0 0 0 1 0 0 0 1 0 0 0 1                           1 0 0 1 1 1 0 0 0 1
1 0 0 0 0 0 0 0 1 0 0 0 1                           1 1 1 1 1 1 0 0 0 1
1 0 0 0 1 0 0 0 1 0 0 0 1                                     1 0 0 0 1
1 0 0 0 1 1 1 1 1 1 0 1 1 1 1 1                               1 1 0 1 1
1 0 0 0 1 1 0 0 0 0 0 0 0 0 0 1                   1 1 1 1 1 1 1 0 0 0 1 1 1 1 1 1 1 1
1 0 0 0 1 1 0 0 0 0 0 0 0 0 0 1                   1 0 0 0 0 0 0 0 0 0 0 0 0 0 0 0 1 1
1 0 0 0 1 1 0 0 0 0 0 0 0 0 0 1                   1 0 0 0 0 0 0 0 0 0 0 0 0 0 0 0 1 1 1 1 1 1
1 0 0 0 0 1 0 0 0 0 0 0 0 0 0 1                   1 0 0 0 0 0 0 0 0 0 0 0 0 0 0 0 0 1 0 0 0 1
1 0 0 0 0 0 0 0 0 0 0 0 0 0 0 1                   1 0 0 0 0 0 0 0 0 0 0 0 0 0 0 0 0 0 0 0 0 1
1 0 0 0 0 1 0 0 0 0 0 0 0 0 0 1                   1 0 0 0 0 0 0 0 0 0 0 0 0 0 0 0 0 1 0 0 0 1
1 0 0 0 1 1 0 0 0 0 0 0 0 0 0 1                   1 0 0 0 0 0 0 0 0 0 0 0 0 0 0 0 1 1 1 1 0 1
1 0 0 0 1 1 0 0 0 0 0 0 0 0 0 1                   1 0 0 0 0 0 0 0 0 0 0 0 0 0 0 0 1 1 1 1 1 1
1 0 0 0 1 1 0 0 0 0 0 0 0 0 0 1                   1 1 1 1 1 1 1 0 0 0 1 1 1 1 1 1 1
1 0 0 0 1 1 1 1 1 1 0 1 1 1 1 1                               1 1 0 1 1
1 0 0 0 1 1 1 1 1 0 0 0 1                                     1 0 0 0 1
1 0 0 0 1 1 1 1 1 0 0 0 1                                     1 0 0 0 1
1 0 0 0 1 0 0 0 1 0 0 0 1                                     1 0 0 0 1
1 0 0 0 0 0 0 0 1 0 0 0 1                                     1 0 0 0 1
1 0 0 0 1 0 0 0 1 0 0 0 1                                     1 0 0 0 1
1 0 0 0 1 1 1 1 1 0 0 0 1                                     1 0 0 0 1
1 0 0 0 1 1 1 1 1 0 0 0 1 1 1 1 1 1 1 1 1 1 1 1 1             1 0 0 0 1
1 0 0 0 0 0 0 0 0 0 0 0 0 0 0 0 0 1 0 0 0 0 0 0 1 1 1         1 0 0 0 1
1 0 0 0 0 0 0 0 0 0 N 0 0 0 0 0 0 0 0 0 0 0 0 0 0 0 1         1 0 0 0 1
1 0 0 0 0 0 0 0 0 0 0 0 0 0 0 0 0 1 0 0 0 0 0 0 1 1 1         1 0 0 0 1
1 1 1 1 1 1 1 1 1 1 1 1 1 1 1 1 1 1 0 1 1 1 1 1 1             1 0 0 0 1
                    1 1 0 0 1 0 0 0 0 0 1           1 1 1 1 1 1 1 0 1 1 1 1 1 1 1
                  1 0 0 0 0 1 0 0 1 0 1             1 0 0 0 0 1 0 0 0 1 0 0 0 0 1
                    1 1 0 0 0 0 0 1 1               1 0 0 0 0 0 0 0 0 0 0 0 0 0 1
                        1 0 1 1 1 1                 1 0 0 0 0 1 0 0 0 1 0 0 0 0 1
                        1 0 0 1                     1 0 0 0 0 1 0 0 0 1 0 0 0 0 1
                        1 0 0 1                     1 1 1 1 1 1 0 0 0 1 1 1 1 1 1
                        1 1 1 1                     1 0 0 0 0 1 0 0 0 1 0 0 0 0 1
                                                    1 0 0 0 0 0 0 0 0 0 0 0 0 0 1
                                                    1 0 0 0 0 1 0 0 0 1 0 0 0 0 1
                                                    1 1 1 1 1 1 0 0 0 1 1 1 1 1 1
                                                    1 0 0 0 0 0 0 0 0 0 0 0 0 0 1
                                                    1 0 0 0 0 0 0 0 0 0 0 0 0 0 1
                                                    1 0 0 0 0 0 0 0 0 0 0 0 0 0 1
                                                    1 1 1 1 1 1 1 1 1 1 1 1 1 1 1