R 1280 720

NO ./textures/eagle.xpm
SO ./textures/bluestone.xpm
EA ./textures/wall_1.xpm
WE ./textures/purplestone.xpm

S ./textures/guard4.xpm

F 0,0,0
C 255,255,255

                                                        1 1 1 1 1 1 1 1 1 1 1 1
          1 1 1 1 1 1                                   1 0 0 0 0 0 0 0 0 0 0 1
          1 0 0 0 0 1             1 1 1 1 1 1 1 1 1 1 1 1 0 0 0 0 0 0 0 0 0 0 1 1 1 1 1
          1 0 0 0 0 1             1 0 0 0 0 0 0 0 0 0 0 1 0 0 0 0 0 0 0 0 0 0 1 0 0 0 1
          1 0 0 0 0 0 1           1 0 0 0 0 0 0 0 0 0 0 0 0 0 0 0 0 0 0 0 0 0 3 0 2 0 1
          1 0 0 0 0 0 1           1 0 0 0 0 0 0 0 0 0 0 1 0 0 0 0 0 0 0 0 0 0 1 0 0 0 1
          1 1 1 1 1 3 1 1 1 1 1   1 0 0 0 1 1 1 1 1 1 1 1 0 0 0 0 0 0 0 0 0 0 1 1 1 1 1
          1 0 0 0 0 0 0 0 0 0 1   1 0 0 0 1             1 0 0 0 0 0 0 0 0 0 0 1
          1 0 0 0 0 0 0 0 0 0 1 1 1 0 0 0 1 1 1         1 1 1 1 1 0 1 1 1 1 1 1
          1 0 0 0 0 0 0 0 0 0 1 0 0 0 0 0 0 0 1               1 0 0 0 1
          1 0 0 0 0 0 0 0 0 0 0 0 0 0 0 0 0 0 1               1 0 0 0 1
          1 0 0 0 0 0 0 0 0 0 1 0 0 0 0 0 0 0 1               1 0 0 0 1
1 1 1 1 1 1 0 0 0 0 0 0 0 0 0 1 1 1 1 1 1 1 1 1               1 0 0 0 1
1 0 0 0 1 1 0 0 0 0 0 0 0 0 0 1                               1 0 0 0 1
1 0 2 0 1 1 1 1 1 1 0 1 1 1 1 1                     1 1 1 1 1 1 0 0 0 1 1 1
1 0 0 0 1 0 0 0 1 0 0 0 1                           1 0 0 0 0 3 0 0 0 0 0 1
1 1 0 1 1 0 0 0 1 0 0 0 1                           1 0 0 1 1 1 0 0 0 1 1 1
1 0 0 0 1 1 1 1 1 0 0 0 1                           1 0 0 1 1 1 0 0 0 1
1 0 0 0 1 0 0 0 1 0 0 0 1                           1 0 0 1 1 1 0 0 0 1
1 0 0 0 3 0 2 0 1 0 0 0 1                           1 1 1 1 1 1 0 0 0 1
1 0 0 0 1 0 0 0 1 0 0 0 1                                     1 0 0 0 1
1 0 0 0 1 1 1 1 1 1 0 1 1 1 1 1                               1 1 0 1 1
1 0 N 0 1 1 0 0 0 0 0 0 0 0 0 1                   1 1 1 1 1 1 1 0 0 0 1 1 1 1 1 1 1 1
1 0 0 0 1 1 0 0 0 0 0 0 0 0 0 1                   1 0 0 0 0 0 0 0 0 0 0 0 0 0 0 0 1 1
1 0 0 0 1 1 0 0 0 0 0 0 0 0 0 1                   1 0 0 0 0 0 0 0 0 0 0 0 0 0 0 0 1 1 1 1 1 1
1 0 0 0 0 1 0 0 0 0 0 0 0 0 0 1                   1 0 0 0 0 0 0 0 0 0 0 0 0 0 0 0 0 1 0 0 0 1
1 0 0 0 0 0 0 0 0 0 0 0 0 0 0 1                   1 0 0 0 0 0 0 0 0 0 0 0 0 0 0 0 0 3 0 0 0 1
1 0 0 0 0 1 0 0 0 0 0 0 0 0 0 1                   1 0 0 0 0 0 0 0 0 0 0 0 0 0 0 0 0 1 0 0 0 1
1 0 0 0 1 1 0 0 0 0 0 0 0 0 0 1                   1 0 0 0 0 0 0 0 0 0 0 0 0 0 0 0 1 1 0 2 0 1
1 0 0 0 1 1 0 0 0 0 0 0 0 0 0 1                   1 0 0 0 0 0 0 0 0 0 0 0 0 0 0 0 1 1 1 1 1 1
1 0 0 0 1 1 0 0 0 0 0 0 0 0 0 1                   1 1 1 1 1 1 1 0 0 0 1 1 1 1 1 1 1
1 0 0 0 1 1 1 1 1 1 0 1 1 1 1 1                               1 1 0 1 1
1 0 0 0 1 1 1 1 1 0 0 0 1                                     1 0 0 0 1
1 0 0 0 1 1 1 1 1 0 0 0 1                                     1 0 0 0 1
1 0 0 0 1 0 0 0 1 0 0 0 1                                     1 0 0 0 1
1 0 0 0 3 0 0 0 1 0 0 0 1                                     1 0 0 0 1
1 0 0 0 1 0 0 0 1 0 0 0 1                                     1 0 0 0 1
1 0 0 0 1 1 1 1 1 0 0 0 1                                     1 0 0 0 1
1 0 0 0 1 1 1 1 1 0 0 0 1 1 1 1 1 1 1 1 1 1 1 1 1             1 0 0 0 1
1 0 0 0 0 0 0 0 0 0 0 0 0 0 0 0 0 1 0 0 0 0 0 0 1 1 1         1 0 0 0 1
1 0 0 0 0 0 0 0 0 0 0 0 0 0 0 0 0 3 0 0 0 0 0 0 0 0 1         1 0 0 0 1
1 0 0 0 0 0 0 0 0 0 0 0 0 0 0 0 0 1 0 0 0 0 0 0 1 1 1         1 0 0 0 1
1 1 1 1 1 1 1 1 1 1 1 1 1 1 1 1 1 1 3 1 1 1 1 1 1             1 0 0 0 1
                    1 1 0 0 1 0 0 0 0 0 1           1 1 1 1 1 1 1 0 1 1 1 1 1 1 1
                  1 2 0 0 0 1 0 0 1 0 1             1 2 0 0 0 1 0 0 0 1 0 0 0 0 1
                    1 1 0 0 3 0 0 1 1               1 0 0 0 0 3 0 0 0 3 0 0 0 0 1
                        1 0 1 1 1 1                 1 0 0 0 0 1 0 0 0 1 0 0 0 0 1
                        1 0 0 1                     1 0 0 0 0 1 0 0 0 1 0 0 0 0 1
                        1 0 0 1                     1 1 1 1 1 1 0 0 0 1 1 1 1 1 1
                        1 1 1 1                     1 0 0 0 0 1 0 0 0 1 0 0 0 0 1
                                                    1 0 0 0 0 3 0 0 0 3 0 0 2 0 1
                                                    1 0 0 0 0 1 0 0 0 1 0 0 0 0 1
                                                    1 1 1 1 1 1 0 0 0 1 1 1 1 1 1
                                                    1 0 0 0 0 0 0 0 0 0 0 0 0 0 1
                                                    1 0 0 0 0 0 0 0 0 0 0 0 0 0 1
                                                    1 0 0 0 0 0 0 0 0 0 0 0 0 0 1
                                                    1 1 1 1 1 1 1 1 1 1 1 1 1 1 1